#########
#.......#
#.o..#x##
#.#.o.$.#
#..@..x.#
#########